#######
#*# #-#
#   # #
### # #
#     #
#######
