###############################
#      #    #      #          #
# #### # #### #### #*######## #
# #    # #       # #        # #
# # #### # ##### # ######## # #
# # #    #   #   #        # # #
# # # ###### # #### ##### # # #
# # # #   #  #    # #   # # # #
# #   # # # ##### # # # #   # #
# ### # # # # * # # # # # ### #
#   # # # # ## ## # # # # #   #
### # # # #  # #  # # # # # ###
#   # # # ## # # ## # # # #   #
# ### # #  # # # #  # # # # # #
# #   # #### # # # ## # #   # #
# # # #      # #####  ####### #
# # #   ######                #
# #######    ##################
#                             #
##############-################
