########^########
#...............#
#.##.#######.##.#
!.#.....*.....#.!
#.##.#######.##.#
#...............#
########!########

$synsvidde = av