###############################
#                      #      #
# ###  ############# # ###### #
#  #####             #      # #
## ##  # ####### ########## # #
#  ##  # #    *# #        # # #
#   ## # # ##### # ###### # # #
#   ## # #         ##   # # # #
#  ##  # #######    # # #   # #
- ###    #     #### # # ##### #
#  ####### ### ##   # # #   # #
#   ##   #  #  #    # # # #*# #
# # #  # #  #  #  # # # # ### #
# #   ##    #     # # # #   # #
# # ##########    #   # #   # #
# # # ###    #######  ##### # #
# # #  #      #    #          #
# # ##    #   # ## ############
#    ### ## ###  #     #    * #
#  #     #       #  #         #
###############################
